{
    "map":
    [
        [5, 0, 6, 6, 6, 6, 6, 6, 6],
        [0, 0, 0, 0, 0, 6, 6, 6, 6],
        [6, 0, 1, 3, 2, 3, 1, 6, 6],
        [6, 0, 3, 4, 0, 4, 3, 5, 6],
        [6, 1, 3, 0, 0, 0, 2, 0, 0],
        [4, 6, 1, 2, 1, 3, 1, 6, 0],
        [4, 4, 6, 0, 0, 0, 6, 0, 0],
        [6, 4, 6, 6, 6, 6, 6, 6, 5]
    ],
    "mapping":["floor", "wall", "door", "window", "softWall", "entrance", "barrier"]
}
